222222222222222222222222222222222222222222222222222222222
211111111111111111111111111111111111121111111111222111112
211111111111111111111111111111111111121111111111222111112
21111111x111111111111111111111111111121111111111111111112
21111@11w111111111111111111111111111121111111111111111112
2111111y1111111111111111111111111111121111111111111111112
211111z11111111111111111111111111111121111111111211111112
2111111111111111111111111111111111111211111c1111111111112
211111111111111111111111111111111111121111111111222111112
211111111111111111111111111111111111121111111111222111112
211111111111111111111111111111111111121111111111111111112
211111111111111111111111111111111111121111111111111111112
211111111111111111111111111111111111121111111111111111112
211111111111111111111111111111111111121111111111111111112
211111111111111111111111111111111111121111111111222111112
2111111111111111111b1111111111111111121111111111111111112
21111111111111111111111111111111as11112111111111122211112
211111111111111111111111111111111111121111111111111111112
21111111111111111111111111111111111112111111d111222111112
222222222222222222222222222222222222222222222222222222222