2222222222222222222222222222222222222222222
2111111111111111111111111111111111122211112
2111111111111111112222211111112222111111112
2211111122111111112211111111122222221111112
2211111111111111111111111111111111111111112
2111111111111111111111111111111222211111122
2111111111111111122221111111111111122222222
22111111111112222111111111111111222
22222222222222222222222222222222222