22222222222222222222222222222222222222222222222222222222222222222222222222222222222
2111111111111111111111111111111111111111111111111111111111111111111111111111111111
21122222222222111111@1111111121111111122222211111121111222222222222222222222222222
211233333333321111111111112211111112222333322222112111233323332333233323332333233
2112333333333211111111112111211111123333333333322111111222222222222222222222222222
2112333333333211221112112111211111123333333333332111111111111111111111111112222111
21123333333332111111y1211111111111123333333333332121111111111111111111111112222111
2c12333333333211111111111121121111123333333333332221111222211112222222222221111222
2a22222222222111111221111112211111223333333333332211112332111123332333233211112333
2111111111111111111111111111111111122222222222222111112222111122222222222211112222
2111111+1111111}111111111111111111111111111111111111111111111111111111111111111111
2111111111111111111111111111111111111111111111111111111111111211111111111111111111
211222222222222111122222222222222211112222222222211111111111211111111111111111111
2222222222222222222222222222222222222222222222222222222222222222222222222222222222222222222222222222222222222222222222222222222222222222222222222222222222222222222222222222222222222222222222222222222222222222222222222222222222222222222222222222