2222222222222222222222222222222222222222222222222222222222222222222222222222222222222222222222222222222222222222222222222222222222222222222222222222222222222222222222222222222222222222222222222222222222222222222222222222222222222222222222222222222222222222222222222222222222222222222222222222222222222222222222222222222222222222222222222222222222222222222222222222222222222222222222222222222222222222
2111111111111111111111111111111111111111111111111111111111111111111111111111111111111112112333333333333333333333333333333211111111111111111111111111111111111111111111*1111111111111111111111111111111111112221111111111111111111111111111111111111112221111111111111111111111111111111111111111111111111111111111221111111111111111111111121111111111111111111111111111111111111111111121111111111211111111212
21122222222222111111@1111111121111111122222211111121111222222222222222222222222222222221211233333333333333333333333333333321112222222211122222222222211112222222222222222222222221111111111111112111111111111112111221111111111111222222111111111111111111111111111111111111111111111111111111111121111111111111111221111111111111111111111222222222211111111111a11111111*1+11111111111111111111111111111111d222
2112333333333211111111111122111111122223333222221121c112333233323332333233323332333233212112333333333333333333333333333333211123333332111233333333332111123333333333333333333333211111111111222111111111111111111111111111111111111111111111111111111111111y1111111111111111111111111112222111111111111111111111111221111111111111111111111233333333211111111111111111111111111111111111122222222222111111111212
2112333333333211111111112111211111123333333333322111111222222222222222222222222222222221211233333333333333333333333333333321112333333211123333333333211112333333333333333333333321111111111111111111111111111111111111111111111111111111111111111111111111111111111111111111111111111111112111111111111111111111111111111111111111111111111233333333211111111111112111111111111111111111123333333332111222222212
2112333333333211221112112111211111123333333333332111111111111111111111111112222111111111211233333333333333333333333333333321112333333211123333333333211112333333333333333333333321111111111111111111111111111111111111111111111111111111111111111111111111111111111111111111111111111111111111111111111111112222222222222222222222222221111233333333211111111111112221111111111111111111123333333332111233333212
21123333333332111111y1211111111111123333333333332121111111111111111111111112222111111111211233333333333333333333333333333321112333222211123333333333211112333333333333333333333321111111111111111111111111111111111111111111111111111111111111111111111111111111111111111111111111111111111111111111121111112333333333333333333333333321111233333333212222222222222222222222222221111111123333333332111233333212
2112333333333211111111111121121111123333333333332221111222211112222222222221111222222221211233333322222222222222222222222221112222111111123333333333211112333333333333333333333321111111111111111111111111111111111111111111111111111111111111111111111111111111111111111111111111111111111111111111121111112333333333333333333333333321111233333333211111233333333333333333333321111111123333333332111233333212
2112222222222211111122111111221111122333333333333221111233211112333233323321111233323321211233333321111111111111111112111111w1111111111b123333333333211112333333333333333333333321111111111111111111111111111111111111111112222111111111111111111111111111111111111111111111111111111111111111111111122222212333333333333333333333333321111233333333211111233333333333333333333321111111123333333332111233333212
2111111111111111111111111111111111112222222222222211111222211112222222222221111222222221211233333321111111111111111111111111111111111111123333333333211112333333333333333333333321111111122221111111111111111111111111111112221111111111111111111111111111111111111111111111111111111111111111111111121111112333333333333333333333333321111233333333211111233333333333333333333321111111123333333332222233333212
21111111+1111111}111111111111111111111111111111111111111111111222222222111122222222121123333332111111222221112333333211111233333321w123333333333211111111111111111111111111111111111111111111122224444444444444444444422211111111221111111111111112222111111111233333333333333333332111111111111122222112333333333333333333333333321111233333333211111233333333333333333333321112111111111111111111233333212
22222222222222222222222222222222222222222222222222222222222222